F 10            ,255                    ,                          254
C 225                   ,               30                     ,       0
NO textures/eagle.xpm
SO      textures/bluestone.xpm
WE                   textures/redbrick_1.xpm                         
EA textures/wood.xpm



        11111111111111111111111111111111111111111111111111
        1000000000110000000000001              0         1
        1011001001110000000000001                        1
        10010010000000000000000011111111111111111111111111
111 111101100000111000000000000001                      
1001000000011000001110111111111111                 
11110111111111011100000010001                           
11110111111111011101010010001
11000000110101011100000010001
10000000000010001100000010001
10000000000000001101010010N01
1100000111010101111101111000111
11110111 1110101 101111010001
11110111 1111111 1111 11111111
11111111
