F 10            ,255                    ,                          254
C 225                   ,               30                     ,       0
NO textures/eagle.xpm
SO      textures/bluestone.xpm
WE                   textures/redbrick_1.xpm                         
EA textures/wood.xpm



11111111111111111111111111111
1000000000110000000000001N  1
1011001001110000000000001   1
10010010000000000000000011111
111 1111011000001110000000001                      
10010000000110000011101111111                 
11110111111111011100000010001                           
11110111111111011101010010001
11000000110101011100000010001
10000000000010001100000010001
10000000000000001101010010001
1100000111010101111101111000111
11110111 1110101 101111010001
11110111 1111111 1111 11111111
11111111
