NO path_to_the_north_texture.xpm
SO path_to_the_south_texture.xpm
F 200, 20, 1
C 225,30,0
WE path_to_the_west_texture.xpm
EA path_to_the_east_texture.xpm




11111111111111111111111111111
10000000001100000000000010001
10110000011100000000000010001
10010000000000000000000010001
11111111101100000111000000001
10000000001100000111011111111
11110111111111011100000010001
11110111111111011101010010001
11000000110101011100000010001
10000000000000001100000010001
10000000000000001101010010001
11000001110101011111011110N01
11110111 1110101 101111010001
11111111 1111111 111111111111